border_size=1
usage=map

_off^_usr, _off^_usr, _off^_usr, _off^_usr, _off^_usr, _off^_usr, _off^_usr, _off^_usr, _off^_usr, _off^_usr, _off^_usr, _off^_usr, _off^_usr, _off^_usr, _off^_usr, _off^_usr, _off^_usr, _off^_usr, _off^_usr, _off^_usr, _off^_usr, _off^_usr, _off^_usr, _off^_usr, _off^_usr, _off^_usr, _off^_usr, _off^_usr, _off^_usr, _off^_usr, _off^_usr, _off^_usr, _off^_usr, _off^_usr, _off^_usr, _off^_usr, _off^_usr, _off^_usr, _off^_usr
_off^_usr, _off^_usr, _off^_usr, _off^_usr, _off^_usr, _off^_usr, _off^_usr, _off^_usr, _off^_usr, _off^_usr, Mm^Xm, _off^_usr, Hh, _off^_usr, Gg^Fet, _off^_usr, Gs^Fp, _off^_usr, Mm, _off^_usr, Ww, _off^_usr, Ww, _off^_usr, Gg^Efm, _off^_usr, Hh, _off^_usr, Mm, _off^_usr, _off^_usr, _off^_usr, _off^_usr, _off^_usr, _off^_usr, _off^_usr, _off^_usr, _off^_usr, _off^_usr
_off^_usr, _off^_usr, _off^_usr, _off^_usr, _off^_usr, _off^_usr, _off^_usr, _off^_usr, Mm^Xm, Mm, Mm^Xm, Hh, Gg, Gs^Fp, Hh, Gg^Uf, Gs^Fms, Hh, Wwf, Wwf, Ww, Ww, Gg, Gg, Gs^Fp, Gs^Fp, Mm, Hh^Uf, Gg^Efm, Ss, Gs^Fp, _off^_usr, _off^_usr, _off^_usr, _off^_usr, _off^_usr, _off^_usr, _off^_usr, _off^_usr
_off^_usr, _off^_usr, _off^_usr, _off^_usr, _off^_usr, _off^_usr, Wwf, Mm, Hh, Mm^Xm, Mm, Gg^Efm, Gg, Gg, Gg, Gg^Efm, Rr, Wwf, Ch, Wwf, Ch, Hh, Gg, Gg, Gg, Ss, Gs^Fms, Hh, Gg, Gg^Uf, Gs^Fms, Wwf, Hh, _off^_usr, _off^_usr, _off^_usr, _off^_usr, _off^_usr, _off^_usr
_off^_usr, _off^_usr, _off^_usr, _off^_usr, Gs^Fp, Hh, Wwf, Gs^Fms, Gs^Fp, Gg^Uf, Gg, Gg, Gg, Gg, Mm, Rr, Wwf, Ch, Kh, 1 Kh, Ch, Gg, Gg, Gg, Ss, Gg, Gg, Gg, Hh, Gg, Wwf, Wwf, Gg^Fet, Hh, Mm, _off^_usr, _off^_usr, _off^_usr, _off^_usr
_off^_usr, _off^_usr, _off^_usr, _off^_usr, Gg, Gg, Wwf, Wwf, Gg, Gg, Gg, Gg, Gg, Gs^Fp, Wwf, Wwf, Gg, Ch, Ch, Ch, Ch, Ch, Gs^Fp, Ss, Mm, Ss, Ss, Gg, Gg, Gs^Fp, Wwf, Wwf, Wwf, Wwf, Wwf, _off^_usr, _off^_usr, _off^_usr, _off^_usr
_off^_usr, _off^_usr, _off^_usr, _off^_usr, Wwf, Wwf, Hh, Gg, Gg^Efm, Gg, Gg, Gg, Gg, Gg, Wwf, Gg, Gs^Fp, Gg, Gg, Ch, Rr, Gg, Ss, Hh, Gs^Fp, Hh^Uf, Gs^Fp, Gg, Wwf, Wwf, Gg, Gg, Gg^Efm, Wwf, Mm^Xm, _off^_usr, _off^_usr, _off^_usr, _off^_usr
_off^_usr, _off^_usr, _off^_usr, _off^_usr, Wwf, Gs^Fms, Mm^Xm, Gs^Fp, Mm, Gg, Wwf, Wwf, Wwf, Wwf, Gs^Fp, Mm^Xm, Mm^Xm, Mm^Xm, Hh, Rr, Gg, Gg, Gg, Gg^Efm, Gg, Hh, Gg, Wwf, Wwf, Wwf, Gg, Gg, Hh, Gs^Fms, Mm^Xm, _off^_usr, _off^_usr, _off^_usr, _off^_usr
_off^_usr, _off^_usr, _off^_usr, _off^_usr, Wwf, Mm, Gg^Uf, Mm^Xm, Hh, Wwf, Gg, Mm, Gg, Gg, Mm, Hh^Uf, Hh^Uf, Mm^Xm, Hh, Rr, Gg, Gg, Gg, Gg, Gg, Gg, Wwf, Wwf, Gg, Gg, Gg, Gg^Uf, Mm^Xm, Mm^Xm, Mm, _off^_usr, _off^_usr, _off^_usr, _off^_usr
_off^_usr, _off^_usr, _off^_usr, _off^_usr, Wwf, Gs^Fp, Gg, Gg^Efm, Wwf, Wwf, Gg^Uf, Gg, Gg, Gg, Hh, Mm^Xm, Gs^Fp, Gs^Fp, Gg, Rr, Hh, Hh, Mm, Gg^Fet, Gg, Gg, Wwf, Wwf, Gg, Gg, Gg, Hh, Mm, Mm^Xm, Mm, _off^_usr, _off^_usr, _off^_usr, _off^_usr
_off^_usr, _off^_usr, _off^_usr, _off^_usr, Gs^Fms, Wwf, Wwf, Wwf, Gg, Gg, Gg, Gg, Gg, Gg^Efm, Gs^Fp, Mm^Xm, Mm^Xm, Hh, Gg, Rr, Rr, Gs^Fp, Hh, Hh, Wwf, Wwf, Wwf, Chr, Chr, Hh, Gg, Gg^Efm, Hh, Mm^Xm, Mm^Xm, _off^_usr, _off^_usr, _off^_usr, _off^_usr
_off^_usr, _off^_usr, _off^_usr, _off^_usr, Hh, Wwf, Hh^Uf, Mm, Gs^Fp, Gg, Rr, Gg, Gg, Gs, Mm^Xm, Mm^Xm, Mm, Gs^Fp, Gg, Gg, Wo, Wo, Wwf, Wwf, Mm^Xm, Hh, Gg, Chw, Wwf, Gg^Fet, Wwf, Gg, Gg, Gs^Fp, Gs^Fms, _off^_usr, _off^_usr, _off^_usr, _off^_usr
_off^_usr, _off^_usr, _off^_usr, _off^_usr, Wwf, Wwf, Wwf, Hh, Rr, Rr, Rr, Gg, Gg, Gs^Fp, Mm^Xm, Mm^Xm, Hh, Gg, Gg, Ww, Gg, Gg, Hh, Rr, Mm^Xm, Mm, Gg, Rr, Rr, Wwf, Rr, Wwf, Wwf, Gg, Wwf, _off^_usr, _off^_usr, _off^_usr, _off^_usr
_off^_usr, _off^_usr, _off^_usr, _off^_usr, Gg^Fet, Gg, Gg, Wwf, Wwf, Wwf, Wwf, Rr, Gg, Mm, Mm^Xm, Rr, Wwf, Gg, Wo, Ww, Gg, Gg, Mm, Mm^Xm, Mm^Xm, Gs^Fms, Gg, Gg, Rr, Rr, Gs^Fms, Hh, Hh^Uf, Wwf, Hh, _off^_usr, _off^_usr, _off^_usr, _off^_usr
_off^_usr, _off^_usr, _off^_usr, _off^_usr, Mm^Xm, Gs^Fp, Hh, Gg, Gg, Gs^Fp, Chr, Chw, Wwf, Hh, Wwf, Wwf, Hh, Wo, Rr, Gg, Gg, Gs^Fp, Mm^Xm, Mm^Xm, Gs^Fp, Gs, Gg, Gg, Gg, Gg, Gg, Mm, Wwf, Wwf, Gs^Fp, _off^_usr, _off^_usr, _off^_usr, _off^_usr
_off^_usr, _off^_usr, _off^_usr, _off^_usr, Mm, Mm^Xm, Mm, Gg^Efm, Gg, Hh, Gg, Chr, Wwf, Wwf, Gg, Hh, Mm, Gg^Fet, Hh, Rr, Gg, Hh, Gs^Fp, Mm^Xm, Hh, Gg^Efm, Gg, Gg, Gg^Uf, Gg, Wwf, Wwf, Gg, Wwf, Wwf, _off^_usr, _off^_usr, _off^_usr, _off^_usr
_off^_usr, _off^_usr, _off^_usr, _off^_usr, Mm, Mm^Xm, Mm^Xm, Hh, Gg, Gg, Gg, Wwf, Wwf, Gg, Gg, Gs^Fp, Gg, Hh, Gg, Rr, Hh, Gs^Fp, Hh^Uf, Mm^Xm, Mm, Gg, Gg, Gg, Gg, Wwf, Hh, Gg, Gg^Uf, Gg^Fet, Wwf, _off^_usr, _off^_usr, _off^_usr, _off^_usr
_off^_usr, _off^_usr, _off^_usr, _off^_usr, Mm^Xm, Mm^Xm, Hh, Gg^Uf, Gg, Gg, Wwf, Wwf, Gg, Gg, Gg, Gg, Gg, Gg, Gg, Rr, Hh, Mm^Xm, Mm^Xm, Hh^Uf, Gs^Fp, Gg, Wwf, Gg, Wwf, Wwf, Mm, Mm^Xm, Mm^Xm, Mm, Wwf, _off^_usr, _off^_usr, _off^_usr, _off^_usr
_off^_usr, _off^_usr, _off^_usr, _off^_usr, Mm^Xm, Gs^Fms, Gg^Efm, Gg, Gg, Wwf, Wwf, Wwf, Gs^Fms, Hh, Gs^Fp, Gg^Efm, Ss, Gg, Rr, Rr, Gg, Mm^Xm, Gs^Fp, Mm^Xm, Wwf, Wwf, Gg, Wwf, Gg, Gg, Gg, Gs^Fp, Hh, Gs^Fms, Wwf, _off^_usr, _off^_usr, _off^_usr, _off^_usr
_off^_usr, _off^_usr, _off^_usr, _off^_usr, Wwf, Wwf, Wwf, Gg, Wwf, Wwf, Gg, Gg, Ss, Hh^Uf, Mm, Hh, Gs^Fp, Gg, Rr, Rr, Rr, Gg, Gg, Gg, Wwf, Gg, Gg, Gg, Gg, Gg, Gg, Gg, Wwf, Wwf, Gg, _off^_usr, _off^_usr, _off^_usr, _off^_usr
_off^_usr, _off^_usr, _off^_usr, _off^_usr, Hh, Wwf, Gs^Fp, Wwf, Wwf, Gs^Fp, Hh, Gg, Gg, Ss, Ss, Ss, Gg, Ch, Ch, Ch, Kh, Ch, Wwf, Wwf, Mm, Gs^Fms, Gg, Gg, Gg, Gg, Gs^Fp, Wwf, Wwf, Gg, Gs^Fp, _off^_usr, _off^_usr, _off^_usr, _off^_usr
_off^_usr, _off^_usr, _off^_usr, _off^_usr, _off^_usr, Mm, Hh, Wwf, Gs^Fms, Gg, Gg, Gg, Gs^Fp, Gg, Gg, Gg, Gg, Ch, Ch, 2 Kh, Ch, Ch, Rr, Rr, Gg, Gg, Gg, Gg, Gs^Fp, Gg^Uf, Hh, Gs^Fp, Wwf, Hh, _off^_usr, _off^_usr, _off^_usr, _off^_usr, _off^_usr
_off^_usr, _off^_usr, _off^_usr, _off^_usr, _off^_usr, _off^_usr, _off^_usr, Wwf, Gs^Fp, Gg^Uf, Gg^Efm, Hh, Mm, Ss, Gs^Fp, Gg, Gg, Ch, Ww, Wwf, Wwf, Ch, Hh, Gg, Gg^Efm, Gg, Gg, Gg^Efm, Mm^Xm, Mm^Xm, Mm^Xm, Mm, _off^_usr, _off^_usr, _off^_usr, _off^_usr, _off^_usr, _off^_usr, _off^_usr
_off^_usr, _off^_usr, _off^_usr, _off^_usr, _off^_usr, _off^_usr, _off^_usr, _off^_usr, _off^_usr, Ss, Mm, Hh, Gs^Fp, Hh^Uf, Gg^Efm, Gg^Efm, Ww, Ww, Ww, Wwf, Mm, Gs^Fp, Gs^Fp, Gg^Uf, Gs^Fp, Gg^Fet, Hh, Hh, Mm^Xm, Mm, _off^_usr, _off^_usr, _off^_usr, _off^_usr, _off^_usr, _off^_usr, _off^_usr, _off^_usr, _off^_usr
_off^_usr, _off^_usr, _off^_usr, _off^_usr, _off^_usr, _off^_usr, _off^_usr, _off^_usr, _off^_usr, _off^_usr, _off^_usr, _off^_usr, _off^_usr, _off^_usr, _off^_usr, _off^_usr, _off^_usr, _off^_usr, _off^_usr, _off^_usr, _off^_usr, _off^_usr, _off^_usr, _off^_usr, _off^_usr, _off^_usr, _off^_usr, _off^_usr, _off^_usr, _off^_usr, _off^_usr, _off^_usr, _off^_usr, _off^_usr, _off^_usr, _off^_usr, _off^_usr, _off^_usr, _off^_usr
_off^_usr, _off^_usr, _off^_usr, _off^_usr, _off^_usr, _off^_usr, _off^_usr, _off^_usr, _off^_usr, _off^_usr, _off^_usr, _off^_usr, _off^_usr, _off^_usr, _off^_usr, _off^_usr, _off^_usr, _off^_usr, _off^_usr, _off^_usr, _off^_usr, _off^_usr, _off^_usr, _off^_usr, _off^_usr, _off^_usr, _off^_usr, _off^_usr, _off^_usr, _off^_usr, _off^_usr, _off^_usr, _off^_usr, _off^_usr, _off^_usr, _off^_usr, _off^_usr, _off^_usr, _off^_usr
